XXXXXXXXXXXXXXXXXXXXXXXXXXXXXXXXXXXXXXXXXXXXXXXXXXXXX
XooXXXXXXXXXXXXXXXXXXXXXXXXXXXXXXXXXXXXXXXXXXXXXXXXXX
XXooooooo**X***********X*********X***X*X*X*****X***XX
XXXXXXXXoXXX*XXXXXXX*X*X*XXXXXXX*XXX*X*X*X*X*X*X*XXXX
XX****oooX***X*****X*X*X*X*********X*******X*X*X*X*XX
XX*XXXoXXXXXXXXX*X*X*XXXXXXX*XXX*XXX*XXX*X*XXXXX*X*XX
XX*Xooo**X*****X*X*********X*X*X*X***X*X*X*********XX
XX*XoX*X*XXX*XXX*XXXXX*XXXXXXX*X*X*XXX*XXXXXXX*XXX*XX
XX*XoX*X*X*X*****X*****X*X***X*X*X***X***X*******X*XX
XXXXoXXX*X*XXX*X*XXXXX*X*X*X*X*X*XXXXXXX*X*X*XXX*X*XX
XX**oX*X*******X*X***X***X*X***X*X*X*X*X*X*X*X***X*XX
XXXXoX*XXXXXXX*XXX*XXXXXXXXXXX*X*X*X*X*X*XXX*X*XXX*XX
XX*XoooXoooX***********X*X*******X***X***X***X***X*XX
XX*XXXoXoXoXXX*XXXXXXXXX*X*XXXXXXX*XXX*XXXXX*XXXXX*XX
XX*X*XoooXoooX*X*********X*X***********X*******X***XX
XX*X*XXXXXXXoXXXXX*XXXXXXX*XXXXXXXXX*XXXXXXX*XXX*X*XX
XX***X***XoooX**ooooooooooo**X***X*X*X*****X*X*X*X*XX
XXXX*X*XXXoXXXXXoXXX*X*XXXoXXXXX*X*X*XXX*XXX*X*XXXXXX
XX*****X*XoooooooX*X*X*X**o**X*****X*X*****X*******XX
XXXX*X*X*XXX*X*XXX*X*XXXXXoXXXXX*X*X*XXXXX*X*XXX*XXXX
XX***X***X***X*X*****X****oX***X*X*X*X*********X***XX
XX*X*XXXXX*XXXXXXX*XXX*XXXoXXX*XXX*X*XXXXX*XXXXXXXXXX
XX*X*X*X*****X***X***X*X*Xo**************X***X*****XX
XX*XXX*X*XXX*X*XXXXXXXXX*XoX*X*XXX*XXXXX*XXX*XXXXX*XX
XX*******X*X*X*X***X*****XoX*X***X*X***X***X*******XX
XXXXXX*XXX*XXX*X*XXX*XXXXXoXXX*X*X*X*XXXXX*XXXXX*XXXX
XX*X***X*X*************X**oooX*X*X***X***X*X*******XX
XX*XXXXX*X*XXX*X*X*XXX*XXXXXoXXXXX*XXX*XXX*X*XXX*XXXX
XX*********X***X*X*X***X*X*XoooooX*X*X*****X*X***X*XX
XX*X*XXXXXXXXX*XXX*XXX*X*X*X*X*XoXXX*XXXXXXXXXXX*X*XX
XX*X***X***X*X*X*X***X*X***X*X*XoX*X*****X*X*****X*XX
XXXX*X*X*XXX*X*X*XXX*XXXXX*X*XXXoX*X*XXXXX*X*XXX*X*XX
XX***X*X*********X*******X***X*Xooo**X*X*X*X*X*****XX
XXXXXX*X*XXXXXXX*XXXXXXX*XXXXX*XXXoXXX*X*X*XXXXX*X*XX
XX*X*X*X*****X*****X************ooo**X*X*********X*XX
XX*X*XXX*XXXXX*X*XXX*XXXXXXXXX*XoXXXXX*XXX*XXX*XXXXXX
XX*X*X***X*****X*X***X*X*X*X***Xooo******X*X*X*****XX
XX*X*XXXXX*X*X*X*XXX*X*X*X*XXX*XXXoXXXXXXXXX*X*XXX*XX
XX***X*X***X*X*X***X***X*X***X***XoooooooX***X*X*X*XX
XX*XXX*X*XXX*XXXXXXXXX*X*X*X*X*XXX*X*XXXoX*X*XXX*X*XX
XX*X*X***X*X***X***X*X*****X*X***X*X***Xo**X*X*X***XX
XX*X*XXX*X*X*XXX*X*X*XXX*X*XXX*XXXXXXXXXoXXXXX*XXX*XX
XX*X*X*X***X*****X*X***X*X*X*X*X*X*****XoooX*X***X*XX
XX*X*X*XXXXXXXXX*XXXXX*X*XXX*X*X*XXX*X*XXXoX*XXX*X*XX
XX*****X***X*X*X***X*****X*X***X*****X**oooX*X*****XX
XX*X*X*X*X*X*X*XXX*X*XXX*X*XXXXXXXXX*X*XoXXX*X*XXXXXX
XX*X*X***X*********X*X*X*X***********X*Xo**X**oooooXX
XXXX*XXX*X*XXXXX*XXX*X*X*X*XXX*XXXXXXX*XoXXXXXoX*XoXX
XX*X***X*X***X***X***X*X*X*X*********X*XoooooooX*XoXX
XX*XXX*XXX*XXXXX*XXX*X*X*X*XXXXXXXXX*X*X*X*X*XXXXXoXX
XX*****X*****X***X*****X*X*********X*X*X*X*X***X**oXX
XXXXXXXXXXXXXXXXXXXXXXXXXXXXXXXXXXXXXXXXXXXXXXXXXXooX
XXXXXXXXXXXXXXXXXXXXXXXXXXXXXXXXXXXXXXXXXXXXXXXXXXXXX
