XXXXXXXXXXXXXXXXXXXXXXXXXXXXXXXXXXXXXXXXXXXXXXXXXXXXX
X**XXXXXXXXXXXXXXXXXXXXXXXXXXXXXXXXXXXXXXXXXXXXXXXXXX
XX*********X***********X*********X***X*X*X*****X***XX
XXXXXXXX*XXX*XXXXXXX*X*X*XXXXXXX*XXX*X*X*X*X*X*X*XXXX
XX*******X***X*****X*X*X*X*********X*******X*X*X*X*XX
XX*XXX*XXXXXXXXX*X*X*XXXXXXX*XXX*XXX*XXX*X*XXXXX*X*XX
XX*X*****X*****X*X*********X*X*X*X***X*X*X*********XX
XX*X*X*X*XXX*XXX*XXXXX*XXXXXXX*X*X*XXX*XXXXXXX*XXX*XX
XX*X*X*X*X*X*****X*****X*X***X*X*X***X***X*******X*XX
XXXX*XXX*X*XXX*X*XXXXX*X*X*X*X*X*XXXXXXX*X*X*XXX*X*XX
XX***X*X*******X*X***X***X*X***X*X*X*X*X*X*X*X***X*XX
XXXX*X*XXXXXXX*XXX*XXXXXXXXXXX*X*X*X*X*X*XXX*X*XXX*XX
XX*X***X***X***********X*X*******X***X***X***X***X*XX
XX*XXX*X*X*XXX*XXXXXXXXX*X*XXXXXXX*XXX*XXXXX*XXXXX*XX
XX*X*X***X***X*X*********X*X***********X*******X***XX
XX*X*XXXXXXX*XXXXX*XXXXXXX*XXXXXXXXX*XXXXXXX*XXX*X*XX
XX***X***X***X***************X***X*X*X*****X*X*X*X*XX
XXXX*X*XXX*XXXXX*XXX*X*XXX*XXXXX*X*X*XXX*XXX*X*XXXXXX
XX*****X*X*******X*X*X*X*****X*****X*X*****X*******XX
XXXX*X*X*XXX*X*XXX*X*XXXXX*XXXXX*X*X*XXXXX*X*XXX*XXXX
XX***X***X***X*X*****X*****X***X*X*X*X*********X***XX
XX*X*XXXXX*XXXXXXX*XXX*XXX*XXX*XXX*X*XXXXX*XXXXXXXXXX
XX*X*X*X*****X***X***X*X*X***************X***X*****XX
XX*XXX*X*XXX*X*XXXXXXXXX*X*X*X*XXX*XXXXX*XXX*XXXXX*XX
XX*******X*X*X*X***X*****X*X*X***X*X***X***X*******XX
XXXXXX*XXX*XXX*X*XXX*XXXXX*XXX*X*X*X*XXXXX*XXXXX*XXXX
XX*X***X*X*************X*****X*X*X***X***X*X*******XX
XX*XXXXX*X*XXX*X*X*XXX*XXXXX*XXXXX*XXX*XXX*X*XXX*XXXX
XX*********X***X*X*X***X*X*X*****X*X*X*****X*X***X*XX
XX*X*XXXXXXXXX*XXX*XXX*X*X*X*X*X*XXX*XXXXXXXXXXX*X*XX
XX*X***X***X*X*X*X***X*X***X*X*X*X*X*****X*X*****X*XX
XXXX*X*X*XXX*X*X*XXX*XXXXX*X*XXX*X*X*XXXXX*X*XXX*X*XX
XX***X*X*********X*******X***X*X*****X*X*X*X*X*****XX
XXXXXX*X*XXXXXXX*XXXXXXX*XXXXX*XXX*XXX*X*X*XXXXX*X*XX
XX*X*X*X*****X*****X*****************X*X*********X*XX
XX*X*XXX*XXXXX*X*XXX*XXXXXXXXX*X*XXXXX*XXX*XXX*XXXXXX
XX*X*X***X*****X*X***X*X*X*X***X*********X*X*X*****XX
XX*X*XXXXX*X*X*X*XXX*X*X*X*XXX*XXX*XXXXXXXXX*X*XXX*XX
XX***X*X***X*X*X***X***X*X***X***X*******X***X*X*X*XX
XX*XXX*X*XXX*XXXXXXXXX*X*X*X*X*XXX*X*XXX*X*X*XXX*X*XX
XX*X*X***X*X***X***X*X*****X*X***X*X***X***X*X*X***XX
XX*X*XXX*X*X*XXX*X*X*XXX*X*XXX*XXXXXXXXX*XXXXX*XXX*XX
XX*X*X*X***X*****X*X***X*X*X*X*X*X*****X***X*X***X*XX
XX*X*X*XXXXXXXXX*XXXXX*X*XXX*X*X*XXX*X*XXX*X*XXX*X*XX
XX*****X***X*X*X***X*****X*X***X*****X*****X*X*****XX
XX*X*X*X*X*X*X*XXX*X*XXX*X*XXXXXXXXX*X*X*XXX*X*XXXXXX
XX*X*X***X*********X*X*X*X***********X*X***X*******XX
XXXX*XXX*X*XXXXX*XXX*X*X*X*XXX*XXXXXXX*X*XXXXX*X*X*XX
XX*X***X*X***X***X***X*X*X*X*********X*X*******X*X*XX
XX*XXX*XXX*XXXXX*XXX*X*X*X*XXXXXXXXX*X*X*X*X*XXXXX*XX
XX*****X*****X***X*****X*X*********X*X*X*X*X***X***XX
XXXXXXXXXXXXXXXXXXXXXXXXXXXXXXXXXXXXXXXXXXXXXXXXXX**X
XXXXXXXXXXXXXXXXXXXXXXXXXXXXXXXXXXXXXXXXXXXXXXXXXXXXX
